0 0 0 0 0 0 0 0 0 0 0 0 0 0 0 0 0 0  0  0  0  0  0  0 0 0  0 0 0 0 0 0 0 0 0 0 0 0 0 0 0 0 0 0 0 0 0 0  0  0 10 10  0 0 0 0 0 0 0 0 0 0 0 0 0 0 0 0 0 0 0 0 0 0  0  0 0 0 0 0 0 0 0 0 0 0 0 0 0 0 0 0 0 0 0 0 0 0 0 0 0 0 0 0 0 0 0  0  0  0  0  0  0  0 0 0 0 0 0 0 0 0 0 0 0 0 0 0 0 0  0  0  0  0 0 0 0 0 0 0 0  0 0 0 0 0 0 0 0 0  0 0  0 0 0 0 0 0 0 0 0 0 0 0 0 0 0 0 0 0 0 0 0 0 0 0 0 0 0 0 0 0 0 0 0 0 0 0 0  0  0  0  0  0  0  0  0  0  0  0  0  0  0  0  0  0  0  0  0  0 0  0  0  0  0  0  0 0 0 0 0 0 0 0 0 0 0  0 0 0 0 0 0  0  0  0  0  0  0  0  0  0  0  0  0  0  0  0  0  0  0  0  0  0  0  0  0  0  0  0  0  0  0  0  0  0  0  0 0 0 0 0 0 0 0 0 0 0 0 0 0 0 0 0  0 0 0 0 10 10 0 0 0 0 0 0 0 0 0 0 0 0 0 0 0 0 0  0 0 0 0 0 0 0  0  0  0  0  0  0  0  0  0  0  0  0  0  0  0  0  0  0  0  0  0  0  0  0  0  0  0  0  0  0  0  0  0  0  0  0  0  0  0  0  0  0  0  0  0 10 10  0  0  0  0  0  0  0  0  0  0  0  0  0  0  0  0  0  0  0  0  0  0  0  0  0  0  0  0  0  0  0  0  0  0  0  0  0  0  0 
0 0 0 0 0 0 0 0 0 0 0 0 0 0 0 0 0 0  0  0  0  0  0  0 0 0  0 0 0 0 0 0 0 0 0 0 0 0 0 0 0 0 0 0 0 0 0 0  0 10  0  0 10 0 0 0 0 0 0 0 0 0 0 0 0 0 0 0 0 0 0 0 0 0  0  0 0 0 0 0 0 0 0 0 0 0 0 0 0 0 0 0 0 0 0 0 0 0 0 0 0 0 0 0 0 0 0  0  0  0  0  0  0  0 0 0 0 0 0 0 0 0 0 0 0 0 0 0 0 0  0  0  0  0 0 0 0 0 0 0 0  0 0 0 0 0 0 0 0 0  0 0  0 0 0 0 0 0 0 0 0 0 0 0 0 0 0 0 0 0 0 0 0 0 0 0 0 0 0 0 0 0 0 0 0 0 0 0 0  0  0  0  0  0  0  0  0  0  0  0  0  0  0  0  0  0  0  0  0  0 0  0 10  0 10  0  0 0 0 0 0 0 0 0 0 0 0  0 0 0 0 0 0  0  0  0  0  0  0  0  0  0  0  0  0  0  0  0  0  0  0  0  0  0  0  0  0  0  0  0  0  0  0  0  0  0  0  0 0 0 0 0 0 0 0 0 0 0 0 0 0 0 0 0  0 0 0 0  0  0 0 0 0 0 0 0 0 0 0 0 0 0 0 0 0 0 0  0 0 0 0 0 0 0  0  0  0  0  0  0  0  0  0  0  0  0  0  0  0  0  0  0 10 10 10  0  0  0  0  0  0  0  0  0  0  0  0  0  0  0  0  0  0  0  0  0  0  0 10  0  0 10  0  0  0  0  0  0  0  0  0  0  0  0  0  0  0  0  0  0  0  0  0  0  0  0  0  0  0  0  0  0  0  0  0  0  0  0  0  0
0 0 0 0 0 0 0 0 0 0 0 0 0 0 0 0 0 0 10 10 10 10 10 10 0 0  0 0 0 0 0 0 0 0 0 0 0 0 0 0 0 0 0 0 0 0 0 0  0  0  8  9  0 0 0 0 0 0 0 0 0 0 0 0 0 0 0 0 0 0 0 0 0 0  0  0 0 0 0 0 0 0 0 0 0 0 0 0 0 0 0 0 0 0 0 0 0 0 0 0 0 0 0 0 0 0 0 10 10 10  0  0  0  0 0 0 0 0 0 0 0 0 0 0 0 0 0 0 0 0  0  0  0  0 0 0 0 0 0 0 0  0 0 0 0 0 0 0 0 0  0 0  0 0 0 0 0 0 0 0 0 0 0 0 0 0 0 0 0 0 0 0 0 0 0 0 0 0 0 0 0 0 0 0 0 0 0 0 0  0  0  0  0  0  0  0  0 10 10  0  0  0  8  9  0  0  0  0  0  0 0 10  0 10  0 10  0 0 0 0 0 0 0 0 0 0 0  0 0 0 0 0 0  0  0  0  0  0  5  6  7  0  0  0  0  0  0  0  0  0  0  0  0  0  0  0  0  0  0  0  0  0  0  0  0  0  0  0 0 0 0 0 0 0 0 0 0 0 8 9 0 0 0 0  0 0 0 0  8  9 0 0 0 0 0 0 0 0 0 0 0 0 5 6 7 0 0  0 0 0 0 0 0 0  0  0  0  0  0  0  0  0  0  0  0  0  0  0  0  0  0 10  0  0  0 10  0  0  0  0  0  0  0  0  0  0  0  0  0  0  0  0  0  0  0  0  0 10  0  0  0  0 10  0  0  0  0  0  0  0  0  0  0  0  0  0  0  0  0  0  0  0  0  0  0  0  0  0  0  0  0  0  0  0  0  0  0  0  0 33
0 0 0 0 0 0 0 0 0 0 0 0 0 0 0 0 0 0  0  0  0  0  0  0 0 0  0 0 0 0 0 0 0 0 0 0 0 0 0 0 0 0 0 0 0 0 0 0  0  0  0  0  0 0 0 0 0 0 0 0 0 0 0 0 0 0 0 0 0 0 0 0 0 0  0  0 0 0 0 0 0 0 0 0 0 0 0 0 0 0 0 0 0 0 0 0 0 0 0 0 0 0 0 8 9 0 0  0  0  0  0  0  0  0 0 0 0 0 0 0 0 0 0 0 0 0 0 0 0 0  0  0  0  0 0 0 0 0 0 0 0  0 0 0 0 0 0 0 0 0  0 0  0 0 0 0 0 0 0 8 9 0 0 0 0 0 0 0 0 0 0 0 0 0 0 5 6 7 0 0 0 0 0 0 0 8 9 0 0  0  0  0  0  0  0  0 10  0  0 10  0  0  0  0  0  0  0  0  0  0 0  0  5  6  7  0  0 0 0 0 0 5 6 7 0 0 0  0 0 0 0 0 0  0  0  0  0  0  0  0  0  0  0  0  0  0  0  8  9  0  0  0  0  0  0  8  9  0  0  0  0  0  0  0  0  0  0  0 8 9 0 0 0 0 0 0 0 0 0 0 0 0 0 0  0 0 0 0  0  0 0 0 0 0 0 0 0 0 0 0 0 0 0 0 0 0 0  0 0 0 8 9 0 0  0  0  0  0  0  0  0  0  0  0  0  0  0  0  0  0  0  0  5  6  7  0  0  0  0  0  0 10 10 10 10  0  0  0  0  0  0  0  0  0  0  0  0  0  0  8  9  0  0  0  0  0  0  0  0  0  0  0  0  0  0  0  0 23 24 25  0  0  0  0  8  9  0  0  0  0  0  0  0  0  0  0  0  0  0  0   
0 0 0 0 0 0 0 0 0 0 0 0 0 0 0 0 0 0  0  0  0  0  0  0 0 0  0 0 0 0 0 0 0 0 0 0 5 6 7 0 0 0 0 0 0 0 0 0  0  0  0  0  0 0 0 0 0 0 0 0 0 0 0 0 8 9 0 0 0 0 0 0 0 0  0  0 0 0 0 0 5 6 7 0 0 0 0 0 0 0 0 0 0 0 0 0 0 8 9 0 0 0 0 0 0 0 0  0  0  0  8  9  0  0 0 0 0 0 0 0 0 0 0 0 0 0 0 0 0 0 10 10 10 10 0 0 0 0 0 0 0  0 0 0 0 0 0 0 0 0 12 0  0 0 0 0 0 0 0 0 0 0 0 0 0 0 0 0 0 8 9 0 0 0 0 0 0 0 0 0 0 0 0 0 0 0 0 0 0  0  0  0  0  0  0  0  0  8  9  0  0  0  0  0  0  0  0  0  0  0 0  0  0  0  0  0  0 0 0 0 0 0 0 0 0 0 0  0 0 0 0 0 0  0  0  0  0  0  0  0  0  0  0  0  0  0  0  0  0  0  0  0  0  0  0  0  0  0  0  0  0  0  0  0  0  0  0  0 0 0 0 0 0 0 0 0 0 0 0 0 0 0 0 0 12 0 0 0  0  0 0 0 0 0 0 0 0 0 0 0 0 0 0 0 0 0 0 16 0 0 0 0 0 0  0  0  0  0  0  0  0  0  0  0  0  0  0  0  0  0  0  0  0  0  0  0  0  0  0  0  0  0  0  0  0  0  0  0  0  0  0  0  0  0  0  0  0  0  0  0  0  0  0  0  8  9  0  0  0  0  0  0  0  0  0  0  0 26 27 28  0  0  0  0  0  0  0  0  0  0  0  0  0  0  0  0  0  0  0 21  
0 0 0 0 0 0 0 0 0 0 0 0 0 0 0 0 0 0  0  0  0  0  0  0 0 0 16 0 0 0 0 0 0 3 4 3 4 3 4 0 0 0 0 0 0 3 4 3  4  0  0  3  4 3 4 3 4 3 4 3 0 0 0 0 0 0 0 0 0 0 0 0 0 0  0  0 0 0 0 0 0 0 0 0 0 0 0 3 4 3 4 3 0 0 0 0 0 0 0 0 0 0 0 0 0 0 0  0  0  0  0  0  0  0 0 0 0 0 0 0 0 3 4 3 4 0 0 0 0 0  0  0  0  0 0 0 0 0 0 0 0 16 0 0 0 0 0 0 0 0 11 0  0 0 0 0 0 0 0 0 0 0 0 0 0 0 0 0 0 0 0 0 0 0 0 0 0 0 0 0 0 0 0 0 0 0 0 0 0  0  0  0  0  0  0  0  0  0  0  0  0  0  0  0 16  0  0  0  0  0 0  0  0  0  0  0  0 0 0 0 0 0 0 0 0 0 0 14 0 0 0 0 0 12  0  0  0  0  0  0  0  0  0 14  0  0  0  0  0  0  0  0 16  0  0  0  0  0  0  0 12  0  0  0  0  0  0  0 0 0 0 0 0 0 0 0 0 0 0 0 0 0 0 0 11 0 0 0  0  0 0 5 6 7 0 0 0 0 0 0 0 0 0 0 0 0 0 15 0 0 0 0 0 0  0  0  0  0  0  0  0 14  0  0  0  0  0  0 14  0  0  0  0  0  0  0  0  0 12  0  0  0  0  0  0  0  0  0 12  0  0 21 20  0  0  0  0  0  0  0  0  0  0  0  0  0  0  0  0  0  0  0  0  0  0  0  0 29  0 30  0  0  0  0  0  0  0  0  0  0  0  0  0  0  0  0  0  0  0 22
0 0 0 0 0 0 0 0 0 0 0 0 0 0 0 0 0 0  0  0  0  0  0  0 0 0 15 0 0 0 0 0 0 2 2 2 2 2 2 0 0 0 2 2 2 2 2 2  2  0  0  2  2 2 2 2 2 2 2 2 0 0 0 0 0 0 0 0 0 0 0 0 0 0 12  0 0 0 0 0 0 0 0 0 0 3 4 2 2 2 2 2 0 0 0 0 0 0 0 0 0 0 0 0 0 0 0  0  0  0  0  0  0  0 0 0 0 0 0 0 0 2 2 2 2 0 0 0 0 0  0  0  0  0 0 0 0 0 0 0 0 15 3 4 3 4 3 4 3 4  3 4  3 4 0 0 0 0 0 0 0 0 0 0 0 0 0 0 0 0 0 0 3 4 0 0 0 0 0 0 0 3 4 0 0 0 0 0 0  0  0  5  6  7  0  0  0  0  0  0  0  0  0  0 15  0  0  0  0  0 0  0  0  0  0  0  0 0 0 0 0 0 0 0 0 0 0 13 0 0 0 0 0 11  0  0  0  0  0  0  0  0  0 13  0  0  0  0  0  0  0  0 15  0  0  0  0  0  0  0 11  0  0  0  0  0  0  0 0 0 0 0 3 4 3 4 3 4 3 4 3 4 3 4  3 4 3 4  3  4 3 4 3 4 3 4 3 4 3 4 3 4 3 4 3 4 3  4 3 0 0 0 0 0  0  0  0  0  0  0  0 13  0  0  0  0  0  0 13  0  0  0  0  0  0  0  0  0 11  0  0  0  0  0  0  0  0  0 11  0  0 22 22  0  0 22 22  0  0  0  0  0  0  0  0  0  0  0  0  0  5  6  7  0  0  0  0 31  0 32  0  0  0  0  0  0  0  0  0  0  0  0  0  0  0  0  0  0  0 22  
3 4 3 4 3 4 3 4 3 4 3 4 3 4 3 4 3 4  3  4  3  4  3  4 3 4  3 4 3 4 0 0 0 2 2 2 2 2 2 0 0 0 2 2 2 2 2 2  2  0  0  2  2 2 2 2 2 2 2 2 0 0 0 0 0 0 3 4 3 4 3 4 3 4 11  0 0 2 2 2 2 2 2 2 2 2 2 2 2 2 2 2 2 0 0 0 0 0 0 0 0 0 0 0 0 0 0  3  4  3  4  3  4  3 4 3 4 0 0 0 0 2 2 2 2 2 2 2 2 2  2  2  2  2 2 2 2 2 2 2 2  2 2 2 2 2 2 2 2 2  2 2  2 2 2 2 2 0 0 0 0 0 0 0 5 6 7 0 0 0 0 0 2 2 0 0 0 0 0 0 0 2 2 0 0 0 0 0 0 17 17 17 17 17 17 17 17 17 17 17 17 17 17 17 17 17 17 17 17  0 0 17  0  0  0  0 17 0 0 0 0 3 4 3 4 3 4  3 4 3 4 0 0 17 17 17 17 17 17 17 17 17 17 17 17 17 17 17 17 17 17 17 17 17 17 17 17 17 17 17 17 17 17 17 17 17 17  0 0 0 0 0 2 2 2 2 2 2 2 2 2 2 2 2  2 2 2 2  2  2 2 2 2 2 2 2 2 2 2 2 2 2 2 2 2 2 2  2 2 0 0 0 0 0 20 21 20 21 20 21 20 21 20 21 20 21 20 21 20 21 20 21 20 21 20 21 20 21 20 21 20 21 20 21 20 21 20 21 20 21 20 22 22 21 20 22 22 21 20 21 20 21  0  0  0  0 20 21 20 21 20 21 20 21 20 21 20 21 20 21 20 21 20 21 20 21 20 21 20 21 20 21 20 21 20 21 20 21 20 22
2 2 2 2 2 2 2 2 2 2 2 2 2 2 2 2 2 2  2  2  2  2  2  2 2 2  2 2 2 2 0 0 0 2 2 2 2 2 2 0 0 0 2 2 2 2 2 2  2  0  0  2  2 2 2 2 2 2 2 2 5 6 7 0 0 0 2 2 2 2 2 2 2 2  2  0 0 2 2 2 2 2 2 2 2 2 2 2 2 2 2 2 2 2 2 2 2 2 2 2 2 2 2 2 2 2 2  2  2  2  2  2  2  2 2 2 2 0 0 0 0 2 2 2 2 2 2 2 2 2  2  2  2  2 2 2 2 2 2 2 2  2 2 2 2 2 2 2 2 2  2 2  2 2 2 2 2 0 0 0 0 0 0 0 0 0 0 0 0 0 0 0 2 2 0 0 0 0 0 0 0 2 2 0 0 0 0 0 0 18 18 18 18 18 18 18 18 18 18 18 18 18 18 18 18 18 18 18 18  0 0 18  0  0  0  0 18 0 0 0 0 2 2 2 2 2 2  2 2 2 2 0 0 18 18 18 18 18 18 18 18 18 18 18 18 18 18 18 18 18 18 18 18 18 18 18 18 18 18 18 18 18 18 18 18 18 18  0 0 0 0 0 2 2 2 2 2 2 2 2 2 2 2 2  2 2 2 2  2  2 2 2 2 2 2 2 2 2 2 2 2 2 2 2 2 2 2  2 2 0 0 0 0 0 22 22 22 22 22 22 22 22 22 22 22 22 22 22 22 22 22 22 22 22 22 22 22 22 22 22 22 22 22 22 22 22 22 22 22 22 22 22 22 22 22 22 22 22 22 22 22 22 22  0  0 22 22 22 22 22 22 22 22 22 22 22 22 22 22 22 22 22 22 22 22 22 22 22 22 22 22 22 22 22 22 22 22 22 22 22
1 1 1 1 1 1 1 1 1 1 1 1 1 1 1 1 1 1  1  1  1  1  1  1 1 1  1 1 1 1 0 0 0 1 1 1 1 1 1 0 0 0 1 1 1 1 1 1  1  0  0  2  2 2 2 2 2 2 2 2 2 2 2 0 0 0 1 1 1 1 1 1 1 1  1  0 0 1 1 1 1 1 1 1 1 1 1 1 1 1 1 1 1 1 1 1 1 1 1 1 1 1 1 1 1 1 1  1  1  1  1  1  1  1 1 1 1 0 0 0 0 1 1 1 1 1 1 1 1 1  1  1  1  1 1 1 1 1 1 1 1  1 1 1 1 1 1 1 1 1  1 1  1 1 1 1 1 0 0 0 0 0 0 0 0 0 0 0 0 0 0 0 1 1 0 0 0 0 0 0 0 1 1 0 0 0 0 0 0 18 18 18 18 18 18 18 18 18 18 18 18 18 18 18 18 18 18 18 18  0 0 18  0  0  0  0 18 0 0 0 0 1 1 1 1 1 1  1 1 1 1 0 0 18 18 18 18 18 18 18 18 18 18 18 18 18 18 18 18 18 18 18 18 18 18 18 18 18 18 18 18 18 18 18 18 18 18  0 0 0 0 0 1 1 1 1 1 1 1 1 1 1 1 1  1 1 1 1  1  1 1 1 1 1 1 1 1 1 1 1 1 1 1 1 1 1 1  1 1 0 0 0 0 0 22 22 22 22 22 22 22 22 22 22 22 22 22 22 22 22 22 22 22 22 22 22 22 22 22 22 22 22 22 22 22 22 22 22 22 22 22 22 22 22 22 22 22 22 22 22 22 22 22  0  0 22 22 22 22 22 22 22 22 22 22 22 22 22 22 22 22 22 22 22 22 22 22 22 22 22 22 22 22 22 22 22 22 22 22 22 